   

  A

    
  ##
  ##
  ##
  ##
  ##
  ##
  ## 
  ##                  h7  ############
  ##                    h7###########""
  ##                    ###########
  ##                    ########### 
  ##                                                 ####
  ##              #########################
##################################################################
##
##
